00000000
00000000
00010002
00000001
11100000
00000111
00011111
00000000
11100000
11100111
10000001
10000001
10000001