00000000
00000000
00000002
00000000
11100000
00000000
00011111
00000000
00000000
11100111
10000001
10000001
10000001