00000000
00000000
00002000
01010101
10301010
01010101
10003010
01010101
10100010
01000101
10101010
01010101
10101010