00000000
01111110
01300010
01011010
01001310
01021010
01001011
01001001
11111101
00100101
00100101
00100101
00333000